"filename", "language", "Python", "Markdown", "JSON", "C++", "CUDA C++", "comment", "blank", "total"
"e:\Melrose-Windows\Code\Python\Neutron\README.md", "Markdown", 0, 2, 0, 0, 0, 0, 1, 3
"e:\Melrose-Windows\Code\Python\Neutron\Tensor.ipynb", "JSON", 0, 0, 294, 0, 0, 0, 1, 295
"e:\Melrose-Windows\Code\Python\Neutron\core\_CUDA_OP.py", "Python", 101, 0, 0, 0, 0, 7, 19, 127
"e:\Melrose-Windows\Code\Python\Neutron\core\_Modules.py", "Python", 64, 0, 0, 0, 0, 58, 14, 136
"e:\Melrose-Windows\Code\Python\Neutron\core\_Operator.py", "Python", 193, 0, 0, 0, 0, 7, 64, 264
"e:\Melrose-Windows\Code\Python\Neutron\core\_Tensor.py", "Python", 95, 0, 0, 0, 0, 44, 23, 162
"e:\Melrose-Windows\Code\Python\Neutron\core\__init__.py", "Python", 5, 0, 0, 0, 0, 0, 0, 5
"e:\Melrose-Windows\Code\Python\Neutron\core\utils.py", "Python", 8, 0, 0, 0, 0, 0, 6, 14
"e:\Melrose-Windows\Code\Python\Neutron\dll\sss.py", "Python", 4, 0, 0, 0, 0, 0, 1, 5
"e:\Melrose-Windows\Code\Python\Neutron\nn\fc_layer.py", "Python", 53, 0, 0, 0, 0, 23, 6, 82
"e:\Melrose-Windows\Code\Python\Neutron\src\MemSchedulor.cu", "CUDA C++", 0, 0, 0, 0, 40, 10, 12, 62
"e:\Melrose-Windows\Code\Python\Neutron\src\array.h", "C++", 0, 0, 0, 15, 0, 7, 6, 28
"e:\Melrose-Windows\Code\Python\Neutron\src\convolution.cu", "CUDA C++", 0, 0, 0, 0, 290, 84, 61, 435
"e:\Melrose-Windows\Code\Python\Neutron\src\operator.cu", "CUDA C++", 0, 0, 0, 0, 276, 87, 75, 438
"e:\Melrose-Windows\Code\Python\Neutron\src\operator.h", "C++", 0, 0, 0, 21, 0, 7, 8, 36
"e:\Melrose-Windows\Code\Python\Neutron\src\runtime_api.h", "C++", 0, 0, 0, 49, 0, 9, 9, 67
"e:\Melrose-Windows\Code\Python\Neutron\tester.py", "Python", 16, 0, 0, 0, 0, 11, 5, 32
"Total", "-", 539, 2, 294, 85, 606, 354, 311, 2191